//MAP CONVERTED BY dmm2tgm.py THIS HEADER COMMENT PREVENTS RECONVERSION, DO NOT REMOVE
"b" = (
/turf/template_noop,
/area/template_noop)
"z" = (
/turf/closed/wall/r_wall,
/area/station/engineering/supermatter/engine)
"D" = (
/turf/template_noop,
/area/template_noop)
"O" = (
/turf/template_noop,
/area/template_noop)

(1,1,1) = {"
O
b
"}
(2,1,1) = {"
z
b
"}
(3,1,1) = {"
b
b
"}
(4,1,1) = {"
b
D
"}
