//MAP CONVERTED BY dmm2tgm.py THIS HEADER COMMENT PREVENTS RECONVERSION, DO NOT REMOVE
"a" = (
/turf/template_noop,
/area/template_noop)
"c" = (
/turf/template_noop,
/area/template_noop)
"i" = (
/turf/template_noop,
/area/template_noop)
"n" = (
/obj/effect/spawner/structure/window/reinforced/plasma,
/turf/template_noop,
/area/station/engineering/supermatter/room)
"p" = (
/turf/template_noop,
/area/template_noop)
"s" = (
/turf/closed/wall/r_wall,
/area/station/engineering/supermatter/room)
"y" = (
/turf/open/floor/engine,
/area/station/engineering/supermatter/room)
"H" = (
/obj/structure/table/reinforced,
/obj/item/clothing/suit/utility/radiation,
/obj/item/clothing/head/utility/radiation,
/obj/effect/turf_decal/stripes/line{
	dir = 1
	},
/obj/item/geiger_counter,
/obj/item/clothing/glasses/meson,
/turf/open/floor/engine,
/area/station/engineering/supermatter/room)

(1,1,1) = {"
a
a
a
a
a
a
a
a
a
a
p
"}
(2,1,1) = {"
a
a
a
a
a
a
a
a
a
a
a
"}
(3,1,1) = {"
i
c
y
a
a
a
a
a
a
a
a
"}
(4,1,1) = {"
a
s
H
a
a
a
a
a
a
a
a
"}
(5,1,1) = {"
a
a
a
a
a
a
a
a
a
a
a
"}
(6,1,1) = {"
a
n
a
a
a
a
a
a
a
a
a
"}
