//MAP CONVERTED BY dmm2tgm.py THIS HEADER COMMENT PREVENTS RECONVERSION, DO NOT REMOVE
"a" = (
/turf/template_noop,
/area/template_noop)
"h" = (
/turf/closed/wall/r_wall,
/area/station/engineering/supermatter/room)
"x" = (
/obj/structure/cable,
/obj/machinery/atmospherics/pipe/smart/manifold4w/supply/hidden/layer4,
/obj/machinery/atmospherics/pipe/smart/manifold4w/scrubbers/hidden/layer2,
/obj/structure/disposalpipe/segment{
	dir = 4
	},
/turf/open/floor/iron,
/area/station/engineering/main)
"C" = (
/turf/open/floor/engine,
/area/station/engineering/supermatter/room)
"R" = (
/turf/closed/wall/r_wall,
/area/station/engineering/supermatter/room)
"V" = (
/turf/template_noop,
/area/template_noop)

(1,1,1) = {"
x
h
C
a
a
a
a
a
"}
(2,1,1) = {"
a
R
a
a
a
a
a
a
"}
(3,1,1) = {"
a
a
a
a
a
a
a
a
"}
(4,1,1) = {"
a
a
a
a
a
a
a
a
"}
(5,1,1) = {"
a
a
a
a
a
a
a
a
"}
(6,1,1) = {"
a
a
a
a
a
a
a
V
"}
